1111111111111111111111111111111111111111111111111111111111111111111111111111111111111111111111111111111111111111111111111111111111111111111111
1                                                  1                        1                                                                1
1          PRESS R TO RESTART IF YOU ARE STUCK     1                        1                                                                1
1 +                                                11111      1111111   111111111                                                            1
1                                                  1                                                                                         1
1                                                  1                                                                                         1
1                                                  1   7                 {                                                                   1
1 +        @                                  +    11111111111111111111111111111111111111                                                    1
1111111111111111111111     1111111     1111111111111                                    1                                                    1
                     1                 1                                                1                                                    1
                     1                 1                                                1                               11111                1
                     1$               $1                                                1                               1                    1
                     1                 1                                                11111111                        1                    1
                     1                 1   1111111111111111111111111111111111111111111111                               1 2 8                1
                     1                 1                                                1                               1111111111111111111111
                     1                 1                                                1                               1
                     1$               $1         {                                    + 1                               1
                     1                 1   11111111111111111111111111        111111111111111111111111111111             1
                     1                 1                            1                   1                               1
                     1                 1                            1                   1                               1
                     1                 1                            1                   1                               1
                     1$               $111111111111                 111111111           1             1111111111111111111
                     1                 1                                                1                               1
                     1                 1                                                1                               1
                     1                 1 5                                              1                             4 1
                     1                 1111111111111111111111111111111111111111111111111111111111111111111111111111111111
                     1                                 111                    1
                     1                                                        1
                     1                                                        1
                     1                                                        1                      
                     1                          +                             1                      
                     1111111111111111111111111111111111   111111111111111111111                      
                                                1$             $1
                                                1     1   1     1
                                                1$             $1
                                                1     1   1     1
                                                1$             $1
                                                11111111111111111