111111111111111111111111111111111111111111111111111111111111111111111111111111111111111111111111111111111111111111111111111111111111111111111111
11111111111111111111111111111111111111111111111111111111111111111111111111111111111111111111111111111111111111111111111111111111111111111111   1
11111111111111111111111111111111111111111111111111111111111111111111111111111111111111111111111111111111111111111111111111111111111111111111   1
11   PRESS THE LEFT OR RIGHT ARROW KEY AND C TO GRAB A BOX    111111111111111111111111111111111111111111111111111111111111111111111111111111   111111111111111111
11                                                                                                        $                                                    $1
11                                                                                                                                                             11
11 @                       +                                                                    {         $                                                    $1
11111111111111111111111111111111111111111111111111111111111111111111   111111111111111111111111111111111111111111111111111111111111111111111   111111111111111111
11                                                                 1   1                                                                       1
11                                                                 1   1                                                                       1
11                                                                 11111                                                                       1
11                                                                                                                                             1
11   PRESS THE DOWN ARROW KEY OR JUMP TO RELEASE THE BOX                                                                                       1
11                                                                                                                                             1
11                                             --------------------------------                                                                1
1111111111111111111111111                      --------------------------------                                                                1
11                                             --------------------------------                                                                1
11                                             --------------------------------                                                                1
11 2                                           --------------------------------            +                                                   1
111111111111111111111111111111111111111111111111111111111111111111111111111111111111111111111111111111111111111111111111111111111111111111111111