1111111111111111111111111111111111111111111111111111111111111111111111111111111111111111111111111111111111111111111111111111111111111111111111111111111111111111111111111111111111
11                                                  ,                                                      11                                                                   11
11             ,   ,                                                                                      11                                                                    11
11                                     ,                          ,                                      11                                                                   4 11
11 5                                                          ,                     ,                   11                                                                   11111
11111                          ,                                                          ,            11                                                              1111     11
    11                                          ,                                                     11                    111   111   111                      111            11
     11                   ,                           ,               ,         ,                    11            1111                      1111   111   111                   11
      11                                    ,                                                       11                                                                          11
       11                                                                   ,                      11       1111----------------------------------------------------------------11
        11            ,           ,                       ,                                       11        11------------------------------------------------------------------11
         11                                                                                      11         11------------------------------------------------------------------11
          11                                                                                    1111111111111111111111111111111111111111111111111111111111111111111111111111111111
          111111111111111111111111111111111111111111111111111111111111111111111111111111111111111111111111111111111111111111111111111111111111111111111111111111111111111111111111
          111111111111111111111111111111111111111111111111111111        CHOOSE ANY ONE OF THE PORTALS !!        11                                                              11
          11               11                                 11                                                11                                                              11
          11               11                                 11      LEADER                         MEMBER     11                                                              11
111111111111               11                                 11       TERRY           @               WAYNE    11                                                      6       11
11                         11   11111111   1111111111111111   11111111111111        1111111           111111111111   11111111111111111111111111111111111111111111   111111111   11
11                         11                            11   11                                                11                                                  11          11
11      +                  11                                 11      MEMBER                         MEMBER     11                                                  11          11
11                         11                {                11        HAO MING     8 2 7            SHUYU     11            +  +  +                    +  +  +  + 11          11
11   1111111111111111111   111111111111111111111111      8    1111111111111111111111111111111111111111111111111111                                                  11   111111111
11                           ----------------------------11                                                                                                         11          11
11                           ----------------------------11                                                                   +  +  +                    +  +  +  + 11          11
11                           ----------------------------11                          4        5        9                                                            11          11
1111111111111111111111111111111111111111111111111111111111111111111111111111111111111111111111111111111111111111111111111111111111111111111111111111111111111111111111111111111111
