111111111111111111111111111111111111111111111111111111111111111111111111111111111111111111111111111111111111111111111111111111111111111111111111111111111111111111111111111111111111111111111111111111111111111
111111111111111111111111111111111111111111111111111111111.111111111111111111111111111111111111111111111111111111111111111 1111111111111111111111111111111111111111111111111111111111111111111111111111111111111
11 THANK YOU        11   11 MADE BY                        LEADER       MEMBER ONE        MEMBER TWO      MEMBER THREE                                                                                       11 
11    FOR PLAYING!  11   11     TEAM EIGHT                    TERRY  7      HAO MING   8       WAYNE   9        SHUYU    2                                                                                   11
1111111111111111111111   11111111111111111111111111111111111111111111111111111111111111111111111111111111111111111111111111111111111111111111111111111111111111111111111111111111111111111111111111111111111111
11                                                                                                                                                                                                           11
11                                                                                                                                                                                                           11
11 @               {                                                                                                                                                                                         11
11111111111111111111111111111111111111111111111111111111111111111111111111111111111111111111111111111111111111111111111111111111111111111111111111111111111111111111111111111111111111111111111111111        11
                                                                                                                                                                                                   11        11
                                                                                                                                                                                                   11        11
                                                                                                                                                                                                   11        11
                                                                                                                                                                                                   11        11
                                                                                                                                                                                                   11        11
                                                                                                                                                                                                   11        11
                                                                                                                                                                                                   11        11
                                                                                                                                                                                                   11        11
                                                                                                                                                                                                   11        11
                                                                                                                                                                                                   11        11
                                                                                                                                                                                                   11        11
                                                                                                                                                                                                   11        11
                                                                                                                                                                                                   11        11
                                                                                                                                                                                                   11        11
                                                                                                                                                                                                   11        11
                                                                                                                                                                                                   11        11
                                                                                                                                                                                                   11        11
                                                                                                                                                                                                   11        11
                                                                                                                                                                                                   11        11
                                                                                                                                                                                                   11        11
                                                                                                                                                                                                   11        11
                                                                                                                                                                                                   11        11
                                                                                                                                                                                                   11        11
                                                                                                                                                                                                   11        11
                                                                                                                                                                                                   11        11
                                                                                                                                                                                                   11        11
                                                                                                                                                                                                   11        11
                                                                                                                                                                                                   11        11
                                                                                                                                                                                                   11        11
                                                                                                                                                                                                   11        11
                                                                                                                                                                                                   11        11
                                                                                                                                                                                                   11        11
                                                                                                                                                                                                   11        11
                                                                                                                                                                                                   11        11
                                                                                                                                                                                                   11        11
                                                                                                                                                                                                   11        11
                                                                                                                                                                                                   11        11
                                                                                                                                                                                                   11        11
                                                                                                                                                                                                   11        11
                                                                                                                                                                                    THE MUMMY      11        11
                                                                                                                                                                                                   11        11
                                                                                                                                                                                                   11        11
                                                                                                                                                                                    THE MUMMY      11        11
                                                                                                                                                                                                   11        11
                                                                                                                                                                                                   11        11
                                                                                                                                                                                    THE MUMMY      11        11
                                                                                                                                                                                                   11        11
                                                                                                                                                                                                   11        11
                                                                                                                                                                                    THE MUMMY      11        11
                                                                                                                                                                                                   11        11
                                                                                                                                                                                                   11        11
                                                                                                                                                                                    THE MUMMY      11        11
                                                                                                                                                                                                   11        11
                                                                                                                                                                                                   11        11
                                                                                                                                                                                    THE MUMMY      11        11
                                                                                                                                                                                                   11        11
                                                                                                                                                                                                   11        11
                                                                                                                                                                                    THE MUMMY      11        11
                                                                                                                                                                                                   11        11
                                                                                                                                                                                                   11        11
                                                                                                                                                                                    THE MUMMY      11        11
                                                                                                                                                                                                   11        11
                                                                                                                                                                                                   11        11
                                                                                                                                                                                    THE MUMMY      11        11
                                                                                                                                                                                                   11        11
                                                                                                                                                                                                   11        11
                                                                                                                                                                                    THE MUMMY      11        11
                                                                                                                                                                                                   11        11
                                                                                                                                                                                                   11        11
                                                                                                                                                                                    THE MUMMY      11        11
                                                                                                                                                                                                   11        11
                                                                                                                                                                                                   11        11
                                                                                                                                                                                             11111111        11
                                                                                                                                                                                             1               11
                                                                                                                                                                                             1               11
                                                                                                                                                                                             1               11
                                                                                                                                                                                             111111111111111111