11111111111111111111111111111111111111111111111111111111111111111111111111111111111111111111111111111111111111111111111111111111111111111111111
11                                     11   11                          11                                1                                  11  
11                                     11   11                          11                                1                                  11
11                   ,                 11 + 11                    8     11      5                         1                 4              @ 11
111111111111                1111111111111   11                    11111111111111111111111111111111111111111111111111111111111111111111111111111
11                                                                11                                               11                        11
11                                                                11                                               11                        11
11              +             7                    6              11                                               11            7           11
11111111111111111111111111111111111111111   111111111111111111111111111111111111111111111111111111111111111111111111111111111111111111111111111
11                                                               11                                                                          11
11                                                               11                                                                          11
11          4                                      9             11                5 6                                                       11
111111111111111111111111111111111111111111111111111111111111111111111111111111111111111111111111111111111$                                  $11
                                                                                                       11                                    11
                                                                                                       11111111                    111111111111
                                                                                                       11    11                    11        11
                                                                                                111111111111111   11111111111111   111111111111
                                                                                                11                                           11
                                                                                                11                                           11
                                                                                                11 2   97          7     6    8      9    4  11
                                                                                                11111111111111111111111111111111111111111111111
