11111111111111111111111111111111111111111111111111111111111111111111111111111111111111111111111111111111111111111111111111111
1111111111111111111111111111111111.111111111111111111111111111111111111--1111111111111111111111111111111111111111111111111111
1                                     11              1               1--1               1              11                 11
1                                     11              1               1--1               1              11                 11
1                                     11                              1--1                              11                 11
1                                     11                              1--1                              11                 11
1                   >>>>>>>>>>>>      11              7             6 1--1 2             9              11                 11
111111111  ,                          111111111111111111111111111111111--111111111111111111111111111111111    1111     111111
1                       ,                                              --                                                  11
1              111111               $          ,    $    ,             ---                                                 11
1     V                                            $           $   5   ---  4                         +                  5 11
1     V                    111111111111    11111111111111111    111111.11.111111111111111111111111111111111111111111111111111
1     V                          11   1                         1                                                          11
1     V                          11   1     >>>>>>>>>>>>>       1                                                          11
1     V                          11   1                         1                                                          11
1     V          11111111        11   111111111111111111111111111                                                          11
1     V                          11    $                          $            $                           $               11
1     V                          11                                                                                        11
1     V                          11                                                                                        11
1     V              11111111111111                                                                                 11     11
1     V                           1                                                            11                   11     11
1     V                           1                                                            11                   11     11
1                                  11          11---1111-----11111---1111111-----1111----111---11                   11     11
1          111111111                11         11----------------------------------------------11                   11     11
1                                    11        11-----------111111111111111111111111-----------11          +        11     11
1                                     1111111111111111111111........111111......11111111111111111111111111111111111111     11
111111                                                                                         11              1           11
1   11            >>>>>>>>>>>>>>>>>>>>>                                                        11                          11
1   11                                                                                         11                          11
1   11                                                                                    4    11       6      8           11
1   1111111111111111111111111111111111111111111111111111111111                       1111111111111111111111111111111111111111
1              $                                       $-----1                       -----                                 11
1              $                                       $-----1                       -----                                 11
1              $                                       $-----11111111    111111111111------                            7   11
1   111111111111111111111111111111111111111        ---------------111    111----------------                          1111111
1                                  11              -----------111111      111111-------------11111111111111111111          11
1                                  11              -----------111111      111111--------------                             11
1          {                       11              -----------                  ------------------                         11
11111111111111111                  1111111111111111-----------                  -------------------                 111111111
1       1      1111111                    --------------------                  ------------------------11                 11
1$,   ,$1                 111111111    -------------------1111111111111111111111111111------------------11                 11
1       1                         ------------------------11                        11------------------11                 11
111111111                         ----                    11                        11                  11                 11
1                                 ----11111111111111111111111111111111111111111111111111111111111111111111      1111111111111
1                                 ----11                                                                11                 11
1                                -----11                                                                11                 11
1         +                    -------11                                 @     8             9          11                 11
11111111111111111111111111111111111111111111111111111111111111111111111111111111111111111111111111111111111111111111111111111