11111111111111111111111111111111111111111111111111111111111111111111111111111111111111111111111111111111111111111111111111111111111111111111111111
11111111111111111111111111111111111111111111111111111111111111111111111111111111111111111111111111111111111111111111111111111111111111111111111111
11                                                      1          1                                                                             1
11         USE THE LEFT AND RIGHT ARROW KEYS TO MOVE    1          1                                                                             1
11                                                      1          1                                                                             1
11                                                      1          1                             PRESS THE DOWN ARROW KEY TO USE THE PORTAL      1
11                                                @     1          1                                                                             1
11                        1111111111111111111111111111111          1                                                                             1
11                                                                 1                                                                             1
11                                                                 1                  111111111111111111111111111111111111111111111111111111111111
11                                                                 1                                     1                                       1
11111111111111111111111111111111111111111111111111111111           1                                     1                                       1
11                                                                 1                                     1                                       1
11                                                                 11111111111111111111111               1                                       1
11                                                                 1                                     1                                       1
11                                                                 1                                     1                                       1
11                                                                 1                                     1                                       1
11                                                                 1               11111111111111111111111                                       1
11               PRESS THE UP ARROW KEY TO JUMP                    1                                     1                                       1
11                                                                 1                                     1                                       1
11                                                                 1                                     1                                       1
11                                                                 111111111111111111111111              1                                       1
11                   11111111111111111111111                                                             1                                       1
11                   11111111111111111111111                                                             1                                       1
11       4           11111111111111111111111                       7                                     12                                      1
11111111111111111111111111111111111111111111111111111111111111111111111111111111111111111111111111111111111111111111111111111111111111111111111111